Автор=Author
АвторизованныйПользователь=AuthorizedUser
АдминистраторСистемы=SystemAdministrator
АдресСхемы=SchemaURL
БизнесПроцесс=BusinessProcess
Вариант=Variant
ВариантНаименование=DescriptionOption
ВариантСсылка=OptionRef
ВариантыОтчетов=ReportsOptions
ВариантыОтчетовКлиент=ReportsOptionsClient
ВерсииПодсистем=SubsystemsVersions
ВерсииПодсистемОбластейДанных=DataAreasSubsystemsVersions
Вид=Kind
ВидСравнения=ComparisonType
ВнешнийОтчет=ExternalReport
Внутренний=BuiltIn
ВыполнитьКомандуПечати=ExecutePrintCommand
ВыполнитьНазначаемуюКомандуПечати=ExecuteAssignablePrintCommand
ВыполняетсяОбновлениеИнформационнойБазы=InfobaseUpdateInProgress
ДобавитьКонечныйРазделительПути=AddLastPathSeparator
Документ=Document
ДополнительныеОтчетыИОбработки=AdditionalReportsAndDataProcessors
ДополнительныеОтчетыИОбработкиКлиент=AdditionalReportsAndDataProcessorsClient
ДополнительныеПараметры=AdditionalParameters
Дополнительный=Additional
ДополнитьСтруктуру=SupplementStructure
ЖурналДокументов=DocumentJournal
Задача=Task
ЗаполнениеДанныхДляОграниченияДоступа=DataFillingForAccessRestriction
Значение=Value
ЗначениеКопирования=CopyingValue
ЗначениеРеквизитаОбъекта=ObjectAttributeValue
ЗначенияПеречисления=EnumValues
Идентификатор=ID
ИдентификаторКомандыПечати=IDOfPrintCommand
ИдентификаторПользователяИБ=IBUserID
ИмяОбъекта=ObjectName
ИмяОтчета=ReportName
ИмяПараметраФормы=FormParameterName
ИмяПользователя=UserName
ИмяФормы=FormName
ИспользоватьРазделениеПоОбластямДанных=UseSeparationByDataAreas
Используется=Used
ИспользуетсяМиграцияПриложений=ApplicationsMigrationUsed
КлючВарианта=VariantKey
КлючСхемы=SchemaKey
Команды=Commands
КомандыПечатиОбъекта=ObjectPrintCommands
КонечнаяТочкаМенеджераСервиса=ServiceManagerEndpoint
Константа=Constant
КритерийОтбора=FilterCriterion
КэшФормы=FormCache
МаксимальныйПорядковыйНомер=MaxSequenceNumber
Менеджер=Manager
МенеджерПечати=PrintManager
НапоминанияПользователяКлиент=UserRemindersClient
НастройкиОтчета=ReportSettings
НастройкиФормыОтчета=ReportFormSettings
НеИспользоватьРазделениеПоОбластямДанных=DoNotUseSeparationByDataAreas
НеразделенныеПользователи=SharedUsers
ОбластиДанных=DataAreas
ОбластьДанныхВспомогательныеДанные=DataAreaAuxiliaryData
ОбменСообщениями=MessagesExchange
ОбновлениеДоступаНаУровнеЗаписей=AccessUpdateOnRecordsLevel
ОбновлениеИнформационнойБазы=InfobaseUpdate
Обработка=DataProcessor
Обработчик=Handler
ОбщаяФорма=CommonForm
ОбщегоНазначения=Common
ОбщегоНазначенияКлиент=CommonClient
ОбщегоНазначенияКлиентСервер=CommonClientServer
Объект=Object
ОбъектыПечати=PrintObjects
ОграничиватьДоступНаУровнеЗаписей=LimitAccessAtRecordLevel
ОграничиватьДоступНаУровнеЗаписейУниверсально=LimitAccessAtRecordLevelUniversally
ОпцииИнтерфейса=InterfaceOptions
ОткрытьФормуОтчета=OpenReportForm
Отчет=Report
ОтчетОбъект=ReportObject
ОтчетыСервер=ReportsServer
ОчиститьПараметрыСеанса=ClearSessionParameters
ПараметрыОткрытия=OpeningParameters
Перечисление=Enum
Перечисления=Enums
ПечатьДокументов=PrintDocuments
ПланВидовРасчета=ChartOfCalculationTypes
ПланВидовХарактеристик=ChartOfCharacteristicTypes
ПланОбмена=ExchangePlan
ПланСчетов=ChartOfAccounts
ПодключаемыеКомандыПовтИсп=AttachableCommandsCached
ПОДСИСТЕМА=SUBSYSTEM
ПодсистемаСуществует=SubsystemExists
ПолноеИмя=FullName
Пользователи=Users
ПорядковыйНомер=SequenceNumber
Представление=Presentation
РаботаВМоделиСервиса=SaaSOperations
РазделениеВключено=DataSeparationEnabled
РазделительВспомогательныхДанных=AuxiliaryDataSeparator
Расширение=Extension
РассылкаОтчетовПереопределяемый=ReportMailingOverridable
РегистрБухгалтерии=AccountingRegister
РегистрНакопления=AccumulationRegister
РегистрРасчета=CalculationRegister
РегистрСведений=InformationRegister
РегламентноеЗадание=ScheduledTask
РегламентноеЗадание.=ScheduledTask.
РедактированиеТабличногоДокумента=EditSpreadsheetDocument
Реквизит=Attribute
СкрытьРабочийСтолПриНачалеРаботыСистемы=HideDesktopOnStart
СозданиеНаОсновании=GenerateFrom
СоздатьКлючЗаписиРегистраСведенийВспомогательныхДанных=CreateAuxiliaryDataInformationRegisterEntryKey
Справочник=Catalog
Ссылка=Ref
СтандартныеПодсистемы=StandardSubsystems
СтандартныеПодсистемыВызовСервера=StandardSubsystemsServerCall
СтандартныеПодсистемыПовтИсп=StandardSubsystemsCached
СтандартныеПодсистемыСервер=StandardSubsystemsServer
Статус=Status
СтатусыОбластейДанных=DataAreaStatuses
СформироватьПриОткрытии=GenerateOnOpen
СхемаМодифицирована=SchemaModified
ТипОтчета=ReportType
ТипыОтчетов=ReportsTypes
УправлениеДоступомСлужебный=AccessManagementInternal
УправлениеПечатью=PrintManagement
УправлениеПечатьюКлиент=PrintManagementClient
УсловияВидимости=VisibilityConditions
УстановитьПустуюФормуНаПустойРабочийСтол=SetBlankFormOnBlankHomePage
УстановитьРазделениеСеанса=SetSessionSeparation
УстановкаПараметровСеанса=SessionParametersSetting
Файлы=Files
Форма=Form
ФормаНастроек=SettingsForm
ФормаНастроекОтчета=ReportSettingsForm
ФормаОбъекта=ObjectForm
ХранитьФайлыВТомахНаДиске=StoreFilesInVolumesOnHardDrive
ЭтоАвтономноеРабочееМесто=IsStandaloneWorkplace
УдалениеПомеченныхОбъектов=MarkedObjectsDeletion
ОтложенноеОбновлениеВГлавномУзлеЗавершеноУспешно=DeferredMasterNodeUpdateCompleted
ОтложенноеОбновлениеЗавершеноУспешно=DeferredUpdateCompletedSuccessfully
Успех=Success
ТекстОшибки=ErrorText
СсылкаОтчета=RefOfReport
ПустаяСсылкаВарианта=EmptyOptionRef
КлючВарианта=VariantKey
СсылкаВарианта=OptionRef1
Комментарий=Comment
Метаданные=Metadata
ДатаНачала=StartDate
Дата=Date
Сеанс=Session
Событие=Event
Уровень=Level
ПредставлениеСобытия=EventPresentation
ИмяПользователя=UserName
Данные=Data
СтатусТранзакции=TransactionStatus
ПредставлениеДанных=DataPresentation
Запись=Record
Открытие=Opening